1111111111111111111111111111111111111111111111111111111111111111111111111111111111111111111111111111111111
1111111111111111111111111111111111111111111111111111111111111111111111111111111111111111111111111111111111
1111111111111111111111111111111111111111111111111111111111111111111111111111111111111111111111111111111111
1111111111111111111111111111111111111111111111111111111111111111111111111111111111111111111111111111111111
1111111111000000000000000000001111111111111111111111111111111111111111111111111111111111111111111111111111
1111111111000000000000000000001111111111111111111111111111111111111111111111111111111111111111111111111111
1111111111000000000000000000001111111111111111111111111111111111111111111111111111111111111111111111111111
1111111111000000000000000E00001111111111111111111111111111111111111111111111111111111111111111111111111111
11111111110000C0000000000000001111111111111100000011111111111111111111111111111111111111111111111111111111
1111111111000000000000000000001111111111111100000011111111111111111111111111111111111111111111111111111111
1111111111000000000000000000001111111111111100000011111111111111111111111111111111111111111111111111111111
1111111111000000000000000000001111111111111100000011111111111111111111111111111111111111111111111111111111
1111111111000000000000000000000000000000000000000011111111111111111111111111111111111111110000000000000011
1111111111000000000000000000000000000000000000000011111111111111111111111111111111111111110000000000000011
1111111111000000000000000000001111111111111100000011111111110000000000000000000000001111110000000000000011
1111111111000000000000000000001111111111111100000011111111110000000000000000000000001111110000C00000000011
1111111111000000000000000000001111111111111100000011111111110000000000000000000000001111110000000000000011
1111111111000000000000000000001111111111111100000011111111110000000000000000000000001111110000000000000011
1111111111000000020000000000001111111111111100000000000000000000000000000000000000000000000000000000000011
1111111111000000000000000000001111111111111100000000000000000000000000000000000000000000000000000000000011
1111111111000000000000000000001111111111111100000011111111110000000000000000000000001111110000000000000011
1111111111000000000000200000001111111111111100000011111111110000000000000000000000001111110000000000000011
1111111111000000000000000000001111111111111100111111111111110000000000000000000000001111110000000000000011
1111111111000000000000000000001111111111111100111111111111110000000000000000000000001111110000000000000011
1111111111001111111111111111111111111111111100111111111111111100111111111111111111001111110000000000000011
1111111111001111111111111111111111111111111100111111111111111100111111111111111111001111110000000000000011
1111111111001111111111111111111111111111111100111111111111111100111111111111111111001111111111110011111111
1111111111001111111111111111111111111111111100111111111111111100111111111111111111001111111111110011111111
1111111111001111111111111111111111111111111100111111111111111100111111111111111111001111111111110011111111
1111111111001111111111111111111111111111111100111111111111111100111111111111111111001111111111110011111111
1111111111001111111111111111111111111111111100111111111111111100111111111111111111001111111111110011111111
1111111111001111111111111111111111111111111100111111111111111100111111111111111111001111111111110011111111
1111111100000000000000001111111100000000000000000000111111111100111111111111111111001111111111110011111111
1111111100000000000000001111111100000000000000000000111111111100111111111111111111001111111111110011111111
1111111100000000000000000000000000000000000000000000111111111100111111111111111111001111111111110011111111
1111111100000000000000000000000000000000000000000000111111111100111111111111111111001111111111110011111111
1111111100000000000000001111111100000000000000000000111111111100111111111111111111001111111111110011111111
1111111100000000000000001111111100000000000000000000111111111100111111111111111111001111111111110011111111
1111111100000000000000001111111100000000000000000000111100000000000000000011111111001111111111110011111111
1111111100000000000000001111111100000000000000000000111100000000000000000011111111001111111111110011111111
1111111100000000000000001111111100000000000000000000000000000000000000000011110000000000001111110000111111
1111111100000000000000001111111100000000000000000000000000000000000000000011110000000000001111110000111111
1111111100000000000000001111111111111111111100111111111100000000000000000011110000000000001111110000111111
1111111100000000000000001111111111111111111100111111111100000000000000000011110000000000001111110000111111
111111110020000C00C000001111111111111111111100111111111100000000000000000000000000000000000000000000111111
1111111100000C00000000001111111111111111111100111111111100000000000000000000000000000000000000000000111111
1111111100000000000000001111111111111111111100111111111100000000000000000011110000000000001111110000111111
111111110000000000000000111111111111111111110011111111110000020000000P000011110000000000001111110000111111
1111111100000000000000001111111100000000000000000000111100000000000000000011110000000000001111110000111111
1111111100000000000000001111111100000000000000000000111100000000000000000011110000000000001111110000111111
1111111100000000000000000000000000000000000000000000000000000000000000000011110000000000001111110000111111
1111111100000000000000000000000000000000000000000000000000000000000000000011110000000000001111110000111111
1111111111111111111111111111111100000000000000000000111100000000000000000011110000000000001111110000111111
1111111111111111111111111111111100000000000000000000111100000000000000000011110000000000001111110000111111
1111111111111111111111111111111100000000000000000000111100000000000000000011111111111111111111110000111111
1111111111111111111111111111111100000000000000000000111100000000000000000011111111111111111111110000111111
1111111111111111111111111111111111111111111111111111111111111111111111111111111111111111111111111111111111
1111111111111111111111111111111111111111111111111111111111111111111111111111111111111111111111111111111111
1111111111111111111111111111111111111111111111111111111111111111111111111111111111111111111111111111111111
1111111111111111111111111111111111111111111111111111111111111111111111111111111111111111111111111111111111
