111111111
10000C0E1
101111101
1P0000021
111111111