111111111
10000C0E1
101111101
1P00C0021
111111111