111111111
10000C0E1
101111101
1P00CC021
111111111