111111111
1000000E1
111111101
1P0CE0021
111111111