111111111
100000001
111111101
1P1CE0021
111111111