111111111111111111111111111111111111111111111111111111111111111111111111111111111
1C0000000000000000000000000000000000000000000000000000000000000000000000000000001
111111111111111111111111111111111111111111111111111111111111111111111111111111001
1000000210000000000000000000000000000000000111111111111111100000000000000000010C1
11001011010000000000000000000000000000C000000000000000000000000000000000000001001
1C0CC0000000000000000000000000010000000000000000000000000000000000000000000101001
111111100000000000000011111111111000000000000000C00000000000000000000000000001001
100C000210000000000000000000000000000000000111111111111111100000000000000000010C1
11001011010000000000000000000000000000C000000000000000000000000000000000000001001
1C0CC0000000000000000000000000010000000000000000000000000000000000000000000101001
111111100000000000000011111111111000000000000000C00000000000000000000000000001001
101C000210000000000000000000000000000000000111111111111111100000000000000000000C1
11011011010000000000000000000000000000C000000000000000000000000000000000000000001
100C000210000000000000000000000000000000000111111111111111100000000000000000000C1
11001011010000000000000000000000000000C000000000000000000000000000000000000000001
1C0CC0000000000000000000000000010000000000000000000000000000000000000000000100001
111111100000000000000011111111111000000000000000C00000000000000000000000000000001
100C000210000000000000000000000000000000000111111111111111100000000000000000000C1
11111011010000000000000000000000000000C000000000000000000000000000000000000000001
100C010210000000000000000000000000000000000111111111111111100000000000000000000C1
11101011010000000000000000000000000000C000000000000000000000000000000000000000001
1C00C0000000000000000000000000010000000000000000000000000000000000000000000100001
111111100000000000000011111111111000000000000000C00000000000000000000000000000001
101C000210000000000000000000000000000000000111111111111111100000000000000000000C1
11111011010000000000000000000000000000C000000000000000000000000000000000000000001
100C000210000000000000000000000000000000000111111111111111100000000000000000000C1
11001011010000000000000000000000000000C000000000000000000000000000000000000000001
1C0CC0000000000000000000000000010000000000000000000000000000000000000000000100001
111111100000000000000011111111111000000000000000C00000000000000000000000000000001
100C000210000000000000000000000000000000000111111111111111100000000000000000000C1
11001011010000000000000000000000000000C000000000000000000000000000000000000000001
100C000210000000000000000000000000000000000111111111111111100000000000000000000C1
11001011010000000000000000000000000000C000000000000000000000000000000000000000001
1C0CC0000000000000000000000000010000000000000000000000000000000000000000000100001
111111100000000000000011111111111000000000000000C00000000000000000000000000000001
100C000210000000000000000000000000000000000111111111111111100000000000000000000C1
11001011010000000000000000000000000000C000000000000000000000000000000000000000001
100C000210000000000000000000000000000000000111111111111111100000000000000000000C1
11001011010000000000000000000000000000C000000000000000000000000000000000000000001
1C0CC0000000000000000000000000010000000000000000000000000000000000000000000100001
111111100000000000000011111111111000000000000000C00000000000000000000000000000001
100C000210000000000000000000000000000000000111111111111111100000000000000000000C1
11001011010000000000000000000000000000C000000000000000000000000000000000000000001
100C000210000000000000000E00000000000000000111111111111111100000000000000000000C1
11001011010000000000000000000000000000C000000000000000000000000000000000000000001
1C0CC0000000000000000000000000010000000000000000000000000000000000000000000100001
111111100000000000000011111111111000000000000000C00000000000000000000000000000001
100C000210000000000000000000000000000000000111111111111111100000000000000000000C1
11001011010000000000000000000000000000C000000000000000000000000000000000000000001
100C000210000000000000000000000000000000000111111111111111100000000000000000000C1
11001011010000000000000000000000000000C000000000000000000000000000000000000000001
1C0CC0000000000000000000000000010000000000000000000000000000000000000000000100001
111111100000000000000011111111111000000000000000C00000000000000000000000000000001
100C000210000000000000000000000000000000000111111111111111100000000000000000000C1
11001011010000000000000000000000000000C000000000000000000000000000000000000000001
100C000210000000000000000000000000000000000111111111111111100000000000000000000C1
11001011010000000000000000000000000000C000000000000000000000000000000000000000001
1C0CC0000000000000000000000000010000000000000000000000000000000000000000000100001
111111100000000000000011111111111000000000000000C00000000000000000000000000000001
100C000210000000000000000000000000000000000111111111111111100000000000000000000C1
11001011010000000000000000000000000000C000000000000000000000000000000000000000001
100C000210000000000000000000000000000000000111111111111111100000000000000000000C1
11001011010000000000000000000000000000C000000000000000000000000000000000000000001
1C0CC0000000000000000000000000010000000000000000000000000000000000000000000100001
111111100000000000000011111111111000000000000000C00000000000000000000000000000001
100C000210000000000000000000000000000000000111111111111111100000000000000000000C1
11001011010000000000000000000000000000C000000000000000000000000000000000000000001
100C000210000000000000000000000000000000000111111111111111100000000000000000000C1
11001011010000000000000000000000000000C000000000000000000000000000000000000000001
1C0CC0000000000000000000000000010000000000000000000000000000000000000000000100001
111111100000000000000011111111111000000000000000C00000000000000000000000000000001
100C000210000000000000000000000000000000000111111111111111100000000000000000000C1
11001011010000000000000000000000000000C000000000000000000000000000000000000000001
100C000210000000000000000000000000000000000111111111111111100000000000000000000C1
11001011010000000000000000000000000000C000000000000000000000000000000000000000001
1C0CC0000000000000000000000000010000000000000000000000000000000000000000000100001
111111100000000000000011111111111000000000000000C00000000000000000000000000000001
100C000210000000000000000000000000000000000111111111111111100000000000000000000C1
11001011010000000000000000000000000000C000000000000000000000000000000000000000001
100C000210000000000000000000000000000000000111111111111111100000000000000000000C1
11001011010000000000000000000000000000C000000000000000000000000000000000000000001
1C0CC00000000000000000000000000100000000000000000000000000000000P0000000000100001
111111100000000000000011111111111000000000000000C00000000000000000000000000000001
100C000210000000000000000000000000000000000111111111111111100000000000000000000C1
11001011010000000000000000000000000000C0000000000000000000000000000000000000000C1
111111111111111111111111111111111111111111111111111111111111111111111111111111111