111111111
1P020C0E1
101111101
100020001
111111111