1111111111111111111111111
1P000C000C0000000000000E1
1011111011101110111111101
10C00000000C00000C0000001
1011101111101111101111101
100000000C000000000000001
1110111011111011101111101
1C000000C0000C00000000C01
1011101111101110111011101
10C000000000C000000000001
1111111111111111111111111