111111111111111111111111111111111111111111111111111111111111
1P000C000C000000000000000000C000000000C000000000000000000E11
101111101110111011111110111011101110111011101111101110111101
10C000C0000C00000C000000000C000C000C00000C00000C00000C000001
101110111110111110111110111011101110111011101111101110111101
10C00C000C00000C00000C000C00000C000C00000C000C00000C00000C01
111011101111101110111110111011101110111011101111101110111111
1C000000C0000C00000000C000000C000C000C00000C00000C00000000C1
101110111110111011101110111011101110111011101111101110111111
10C000C00000C000C00000C00000C000C00000C000C00000C000C0000001
101111101110111011111110111011101110111011101111101110111111
10000C000C000000000000000000C000000000C000000000000000000001
101111101110111011111110111011101110111011101111101110111111
10C000C0000C00000C000000000C000C000C00000C00000C00000C000001
101110111110111110111110111011101110111011101111101110111111
10C00C000C00000C00000C000C00000C000C00000C000C00000C00000C01
111011101111101110111110111011101110111011101111101110111111
1C000000C0000C00000000C000000C000C000C00000C00000C00000000C1
101110111110111011101110111011101110111011101111101110111111
10C000C00000C000C00000C00000C000C00000C000C00000C000C0000001
101111101110111011111110111011101110111011101111101110111111
10000C000C000000000000000000C000000000C000000000000000000001
101111101110111011111110111011101110111011101111101110111111
10C000C0000C00000C000000000C000C000C00000C00000C00000C000001
101110111110111110111110111011101110111011101111101110111111
10C00C000C00000C00000C000C00000C000C00000C000C00000C00000C01
111011101111101110111110111011101110111011101111101110111111
1C000000C0000C00000000C000000C000C000C00000C00000C00000000C1
111111111111111111111111111111111111111111111111111111111111
