11111111111111111111
10000C000C00000000E1
10111110111011101111
10C000C0000C00000001
10111011111011111011
10C00C000C00000C0001
11101110111110111011
1P00000C0000C00000C1
11111111111111111111