111111111
1P000C0E1
101111101
100000001
111111111