1111111111111
10010CCCCC0C1
1000011C11001
1P0C111C0E101
1111111111111