11111111111111111111111111
10010CCCCC0C000010C000C0C1
10010110110011000011C11001
10111110011011P0C111C00101
10010CC0CC0C110010CC00C0C1
10000000000011001000C000C1
100C111C0E10000010C000C0C1
11111111111111111111111111