1111111111111111111111111
10000C000P0000000000000E1
1111111111100111111111111
10000000000000000C0000001
1011101111101111101111101
100002000C000000000000001
1110111011111011101111101
1C000000C0000C00200000C01
1011101111101110111011101
10C000200000C000000000001
1111111111111111111111111