1111111111111111111111111111111111111111111111111111
1P000C000C000000000000000000C000000000C0000000000E11
1011111011101110111111101110111011101111101110111101
10C000C0000C00000C000000000C00000C00000C00000C000001
10C00C000C00000C00000C000C00000C000C00000C000C000001
1110111011111011101111101110111011101110111110111111
1011101111101110111011101110111011101100001110111111
10C000C00000C000C00000C00000C000C00000C000C00000C001
1011111011101110111111101110111011101110111110111111
10000C000C00000000000000000000C000000000000000000001
1011111011101110111111101110111011101111101110111111
10C000C0000C0000000C000C000C00000C00000C00000C000001
1011101110111110111011101110111011101111101110111111
10C00C000C00000C00000C000C00000C000C0000000C00000C01
1110111011111011101111101110111011101110111011111111
1C000000C0000C00000000C000000C00000C00000C00000000C1
1011101111101110111011101110111011101111101110111111
10C000C00000C0000000C000C00000C000C00000C000C0000001
1011111011111110111011101110111011101111101110111111
10000C000C000000000000000000C000000000C0000000000001
1011111011101110111111101110111011101110001110111111
10C000C0000C00000C000000000C000C0C00000C00000C000001
1011101111101111101111100110111011101111101110111111
10C00C000C00000C00000C000C00000C000C00000C000C000C01
1111111111111111111111111111111111111111111111111111